AAA	!
AAC	#
AAG	$
AAT	%
AA_	&
ACA	(
ACC	)
ACG	*
ACT	+
AC_	-
AGA	.
AGC	0
AGG	1
AGT	2
AG_	3
ATA	4
ATC	5
ATG	6
ATT	7
AT_	8
A__	9
CAA	;
CAC	<
CAG	=
CAT	?
CA_	@
CCA	A
CCC	B
CCG	C
CCT	D
CC_	E
CGA	F
CGC	G
CGG	H
CGT	I
CG_	J
CTA	K
CTC	L
CTG	M
CTT	N
CT_	O
C__	P
GAA	Q
GAC	R
GAG	S
GAT	T
GA_	U
GCA	V
GCC	W
GCG	X
GCT	Y
GC_	Z
GGA	[
GGC	]
GGG	_
GGT	a
GG_	b
GTA	c
GTC	d
GTG	e
GTT	f
GT_	g
G__	h
TAA	i
TAC	j
TAG	k
TAT	l
TA_	m
TCA	n
TCC	o
TCG	p
TCT	q
TC_	r
TGA	s
TGC	t
TGG	u
TGT	v
TG_	w
TTA	x
TTC	y
TTG	z
TTT	{
TT_	}
T__	~
